Latinized Greek	 Greek
aeri*otas	αελιποτας
aetistos	αεθιστος
etizo	εθιζω
adamao	αδαμαο
adamas	αδαμας
adamefeis	αδαμεfεις
adameus	αδαμευς
adrastios	αδραστιος
andeter	ανδετηρ
andeteres	ανδετηρες
andriantei	ανδριαντει
andriapi	ανδριαφι
andrios	ανδριος
aner	ανερ
adinfatas	αδινfατας
aiasmena	αιασμενα
aiasmenos	αιασμενος
arkmanor	αλκμανωρ
akaranos	ακαρανος
akasion	ακασιον
akasionei	ακασιονει
aktaios	ακταιος
akaifia	αχαιfια
akaifiande	αχαιfιανδε
akaia	αχαια
akaifos	αχαιfος
akaios	αχαιος
akeen	αγεεν
akei	αγει
ako	αγω
arkeus	αλκευς
arkeioio	αργειοιο
arkeios	αργειος
arkerafos	αρχελαfος
arkerafon	αρχελαfων
akeirein	αγειρειν
akeiro	αγειρω
akreuten	αγρευθεν
akreus	αγρευς
akrefa	αγρεfα
akrefande	αγρεfανδε
akrefios	αγρεfιος
akkeros	αγγελος
akeron	αχερων
aketeres	αγετερες
asketeres	ασκετερες
asketriai	ασκητριαι
asketriaon	ασκητριαων
akireus	αχιλευς
aktistos	ακτιστος
aikiharia	αιγιhαλια
aikihariande	αιγιhαλιανδε
akora	αγορα
akoraia	αγοραια
akoraios	αγοραιος
akros	αγρος
aksones	αξονες
aksotas	ακσοτας
arkoteus	αργοθευς
aktor	ακτωρ
akton	αχθων
aktoinos	ακτοινος
akorfos	ακορfος
arkuros	αργυρος
amarutao	αμαρυταο
amarutas	αμαρυτας
amnisios	αμνισιος
amnisonde	αμνισονδε
amnisos	αμνισος
armon	αρμον
armosi	αρμοσι
armota	αρμοτα
armote	αρμοτε
armoientoi	αρμοιεντοι
armoteon	αρμοτεων
armoteonande	αρμοτεωνανδε
armoster	αρμοστηρ
armosteres	αρμοστηρες
armotefia	αρμοθηfια
amuntafon	αμυνθαfων
anaita	αναιτα
anaiton	αναιτον
anarmosta	αναρμοστα
anarmoston	αναρμοστον
anam*ukes	αναμπυκες
aneuten	ανευθεν
aneus	ανευς
aneutei	ανευτει
anemon	ανεμων
iereia	ιερεια
aneta	ανετα
aniemi	ανιημι
ania	ανια
aniapi	ανιαφι
enia	ηνια
aniatos	ανιατος
anonon	ανονον
anonon	ανωνον
ano*os	ανωπος
anofeis	ανωfεις
anoftos	ανωfτος
anukos	ανυκος
anutos	ανυτος
ar*akeus	αρπαγευς
apareus	αφαρευς
apsakios	αψαγιος
as*arta	ασπαρτα
a*tarfa	απταρfα
a*tera	απτερα
a*tarfaia	απταρfαια
a*tarfaios	απταρfαιος
a*easa	απεασα
a*eimi	απειμι
a*eontes	απεοντες
a*eeke	απεηκε
apiemi	αφιημι
a*eritafon	απελιταfων
apetriai	αφετριαι
ampi	αμφι
ampiekein	αμφιεχειν
ampieko	αμφιεχω
ampidoros	αμφιδωρος
ampiakros	αμφιαγρος
ampiareus	αμφιαρευς
ampiarefos	αμφιαρηfος
ampiketas	αμφιγετας
ampimedes	αμφιμηδης
ampinoefioi	αμφινοεfιοι
ampiporeus	αμφιφορευς
ampiporefes	αμφιφορηfες
ampi*oros	αμφιπολος
ampi*otas	αμφιποτας
ampiqatos	αμφιβατος
ampi*otos	αμφιποτος
ampirafos	αμφιλαfος
ampirafon	αμφιλαfων
ampiharos	αμφιhαλος
amponefei	αμφονεfει
amponeus	αμφονευς
ampoterai	αμφοτεραι
ampoteroten	αμφοτερωθεν
a*edoke	απεδωκε
a*odido	αποδιδω
a*udoke	απυδωκε
a*odosis	αποδοσις
a*udosis	απυδοσις
am*ukes	αμπυκες
am*uks	αμπυξ
am*ukoforkos	αμπυκοfοργος
amqatos	αμβατος
akqaimon	ακβαιμων
amqotas	αμβοτας
arakateiai	αλακατειαι
arakateiaion	αλακατειαιον
ararmotemena	αραρμοτημενα
ararmotemenos	αραρμοτημενος
araruia	αραρυια
ararufoa	αραρυfοα
araruonta	αραρυοντα
areia	αρεια
areios	αρειος
areksandra	αλεξανδρα
arekseus	αλεξευς
areksitoio	αλεξιτοιο
areksitos	αλεξιτος
arektrufon	αλεκτρυfων
areimenes	αρειμενης
areipar	αλειφαρ
aroipe	αλοιφη
areipazoos	αλειφαζοος
areipoqios	αλειφοβιος
aroura	αρουρα
asamintos	ασαμινθος
asiatiai	ασιατιαι
asifia	ασιfια
asifios	ασιfιος
atamaneus	αθαμανευς
atamas	αθαμας
antanor	αντανωρ
ataransios	αταλανσιος
artemitios	αρτεμιτιος
antemon	ανθεμων
artemon	αρτεμων
atreifia	ατρειfια
atefei	ατηfει
artemis	αρτεμις
artimitei	αρτιμιτει
arto*oios	αρτοποιος
arto*o*os	αρτοποπος
antro*os	ανθρωπος
antro*o	ανθρωπω
atukos	ατυγος
atukos	ατυκος
afeikseus	αfειξευς
apu	αφυ
apufei	αφυfει
apunde	αφυνδε
apukanes	αφυγανες
areiona	αρειονα
arioa	αριοα
areiones	αρειονες
arioes	αριοες
areionos	αρειονος
arioio	αριοιο
eensi	εενσι
eimi	ειμι
eneensi	ενεενσι
eneimi	ενειμι
eimi	ειμι
eon	εων
euormos	ευορμος
eudamos	ευδαμος
eudeiferos	ευδειfελος
eudonos	ευδονος
euketoi	ευχετοι
eukomai	ευχομαι
eukomenos	ευχομενος
eumedes	ευμεδης
eumenes	ευμενης
eumetas	ευμετας
eunafos	ευναfος
eu*rofos	ευπλοfος
eurudamos	ευρυδαμος
euru*toremoio	ευρυπτολεμοιο
euru*toremos	ευρυπτολεμος
euru*otas	ευρυποτας
eutarefosforfos	ευθαλεfοςfορfος
euakros	ευαγρος
edaeus	εδαευς
eidomeneus	ειδομενευς
ekma	εγμα
ekmatei	εγματει
ekmapi	εγμαφι
eskara	εσχαρα
krao	γραω
ekkraefeis	εγγραεfεις
ekeen	εχεεν
ekei	εχει
ekein	εχειν
ekonsi	εχονσι
ekousi	εχουσι
ekedamos	εχεδαμος
ekedamon	εχεδαμων
ekkeimai	εγκειμαι
ekkeiontoi	εγκειοντοι
ekemedes	εχεμηδης
ekkeros	εγχερος
ekkero*onoi	εγχεροπονοι
ekeriafon	εχελιαfων
erkinos	εργινος
ekinos	εχινος
ekontes	εχοντες
ekon	εχων
ekkensi	εγχενσι
ekkos	εγχος
erkomenatao	ερχομεναταο
erkomenatas	ερχομενατας
erkomenos	ερχομενος
orkomenos	ορχομενος
ekson	εξων
eksonos	εξωνος
eksoforkoi	εξωfοργοι
ektor	εκτωρ
ekkeo	εγχεω
ekkusefes	εγχυσηfες
ermahai	ερμαhαι
ermahas	ερμαhας
ermes	ερμης
emei	εμει
eni	ενι
emmistos	εμμισθος
emmiston	εμμισθων
ena*rous	εναπλους
eneka	ενεκα
enesidaonei	ενεσιδαονει
enesidaon	ενεσιδαων
ennefo*eza	εννεfοπεζα
eni*ateufei	ενιπατευfει
eni*ateus	ενιπατευς
enufarios	ενυfαλιος
e*i	επι
o*i	οπι
e*ididastoi	επιδιδαστοι
e*ididomi	επιδιδωμι
epiartas	εφιαλτας
e*ikitonia	επιχιτωνια
e*ikorfoi	επικορfοι
e*ifestrios	επιfεστριος
e*izosta	επιζωστα
emqaros	εμβαρος
e*esia	επεσια
e*esios	επεσιος
e*etas	επετας
era	ερα
era	ερα
eraia	εραια
errammene	ερραμμενη
erra*mena	ερραπμενα
rammene	ραμμενη
erapon	ελαφων
rimenes	λιμενες
eratra	εραθρα
eratei	ελατει
eratonde	ελατονδε
eratos	ελατος
erateios	ελατειος
eratrefa	εραθρεfα
eratrefei	εραθρεfει
eraifon	ελαιfον
eraion	ελαιον
ereei	ελεει
eros	ελος
ereen	ερεεν
erettein	ερεττειν
ereus	ερευς
ereutera	ελευθερα
ereuteros	ελευθερος
ereuterai	ελευθεραι
ereuterei	ελευθερει
ereutero	ελευθερω
ereuteroseen	ελευθερωσεεν
ereutia	ελευθια
eremos	ερεμος
eremon	ερημον
erepantei	ελεφαντει
erepanteiapi	ελεφαντειαφι
erepanteios	ελεφαντειος
erepantos	ελεφαντος
erepas	ελεφας
eretai	ερεται
eretas	ερετας
eretaon	ερεταων
erika	ελικα
erikas	ελικας
erike	ελικη
erikrefeis	ερικλεfεις
erikreus	ερικλευς
erikorfos	ερικορfος
erinus	ερινυς
erita	εριθα
eromantos	ελομανθος
erumantos	ερυμανθος
erropakeia	ελλοφαγεια
erropaketas	ελλοφαγετας
erropakeus	ελλοφαγευς
erumniai	ελυμνιαι
erutra	ερυθρα
erutras	ερυθρας
erutros	ερυθρος
esareus	εσαλευς
esaros	εσαλος
esarefia	εσαλεfια
etakeus	εταγευς
etafoneus	εταfονευς
enten	ενθεν
etefas	ετεfας
etefokrefeios	ετεfοκλεfειος
eteokrios	ετεοκλιος
entoikia	εντοιχια
etonion	ετωνιον
entro*atai	εντροπαται
tro*oter	τροπωτηρ
entosforkoi	εντοσfοργοι
efepsesomena	εfεψεσομενα
eutrossestai	ευτροσσεσθαι
efri*ia	εfριπια
efri*os	εfριπως
euri*os	ευριπος
efitaios	εfιταιος
efitefios	εfιτεfιος
efitefei	εfιτεfει
efiteus	εfιτευς
ezofos	εζωfος
idomeneia	ιδομενεια
idomeneios	ιδομενειος
iater	ιατερ
iater	ιατηρ
iafonei	ιαfονει
iafon	ιαfων
ierefos	ιερεfος
iereus	ιερευς
iereia	ιερεια
ierefios	ιερεfιος
ieros	ιερος
ieroforkos	ιεροfοργος
ierourkos	ιερουργος
ientoi	ιεντοι
ieto	ιετο
iemi	ιημι
kios	γιος
iefei	ιεfει
ios	ιος
uios	υιος
iemi	ιημι
iontes	ιοντες
iketas	ικετας
iketes	ικετης
ikeus	ικευς
inia	ινια
ipemedeia	ιφεμεδεια
ipimedeia	ιφιμηδεια
ipemedeiaion	ιφεμεδειαιον
ipsefas	ιψεfας
i*nos	ιπνος
i**ia	ιππια
i**io	ιππιω
i**os	ιππος
isukufdotos	ισυχυfδοτος
iteiai	ιθειαι
iteiaon	ιθειαων
iteus	ιθευς
ituno	ιθυνω
ifaks	ιfαξ
ifasos	ιfασος
oudidonsi	ουδιδονσι
oudidontoi	ουδιδοντοι
ouke	ουκε
oute	ουτε
outermis	ουτερμις
ouforzei	ουfορζει
odrufei	οδρυfει
odrus	οδρυς
odrufia	οδρυfια
odrufios	οδρυfιος
arke	αρχη
orka	ορχα
oikarai	οιχαλαι
oikareai	οιχαλεαι
orkomeneus	ορχομενευς
okunafos	οκυναfος
okunafon	οκυναfων
ormos	ορμος
ormopi	ορμοφι
onata	ονατα
onaton	ονατον
oneomai	ωνεομαι
onateres	ονατερες
ornita	ορνιθα
ornitiapi	ορνιθιαφι
ornis	ορνις
onos	ονος
onoi	ωνοι
onuks	ονυξ
onukes	ονυχες
or*a	ολπα
o*ra	οπλα
opeire	οφειλη
operos	οφελος
operonsa	οφελονσα
operontas	οφελοντας
operontes	οφελοντες
opeirousi	οφειλουσι
operonsi	οφελονσι
opertas	οφελτας
e*i	επι
o*i	οπι
o*iiapi	οπιιαφι
o*idesmoi	οπιδεσμοι
o*iskapeefes	οπισκαφεεfες
o*ikeremnia	οπικελεμνια
o*ikeremniapi	οπικελεμνιαφι
o*irimnios	οπιλιμνιος
o*rimnios	οπλιμνιος
o*isukos	οπισυγος
o*iteukeeus	οπιτευχεευς
o*iteteres	οπιθετηρες
o*ihara	οπιhαλα
o*o*oi	οπωποι
o*o*o	οπωπω
opeiro	οφειλω
opron	ωφλον
orei	ορει
oros	ορος
orestas	ορεστας
oromenos	ορομενος
oro	ορω
orumantos	ορυμανθος
otan	οταν
ote	οτε
ortinafos	ορτιναfος
ortinafon	ορτιναfων
fide	fιδε
oro	ορω
ofidetai	οfιδεται
ofidetas	οfιδετας
ofitonioi	οfιτονιοι
ofitnos	οfιτνος
ofos	οfος
ofofeis	οfωfεις
ous	ους
udros	υδρος
u*o	υπο
uraios	υλαιος
uramnos	υλαμνος
ureus	υλευς
fru*iaioi	fρυπιαιοι
frumai	fρυμαι
fruntoi	fρυντοι
utaioio	υταιοιο
utaios	υταιος
utanos	υτανος
ufatas	υfατας
urion	υλιων
urion	υριων
dai*ontas	δαιποντας
daitraros	δαιτραρος
dadareion	δαδαλειον
dadareionde	δαδαλειονδε
daiaros	δαιαρος
damater	δαματερ
damates	δαματες
dumates	δυματες
damnios	δαμνιος
damos	δαμος
demos	δημος
damokros	δαμοκλος
daron	δαρων
dataiaros	δαταιαρος
dafeupi	δαfευφι
dafos	δαfος
dafon	δαfων
dafia	δαfια
dafios	δαfιος
dapurintoio	δαφυρινθοιο
raqurintos	λαβυρινθος
deukarion	δευκαλιων
deukioio	δευκιοιο
deukios	δευκιος
dedemenos	δεδεμενος
dedikuia	δεδικυια
didasko	διδασκω
dedomena	δεδομενα
dido	διδω
didomi	διδωμι
deksato	δεξατο
dekomai	δεχομαι
dektuforkos	δεκτυfοργος
demeontes	δεμεοντες
demo	δεμω
demnia	δεμνια
dei*non	δειπνον
dreukos	δλευκος
desmois	δεσμοις
desmos	δεσμος
difia	διfια
diuia	διυια
difiaionde	διfιαιονδε
diuaion	διυαιον
diuafon	διυαfων
difios	διfιος
diuos	διυος
didaskarei	διδασκαλει
didaskaros	διδασκαλος
dikta	δικτα
diktande	δικτανδε
dikte	δικτη
diktaios	δικταιος
dikonareia	δικοναρεια
dikonaros	δικοναρος
de*as	δεπας
di*as	διπας
dipsiefios	διψιεfιος
dipsia	διψια
dipsios	διψιος
dipsos	διψος
dipsoi	διψωι
drimios	δριμιος
diros	διρος
difei	διfει
difos	διfος
dias	διας
zeus	ζευς
dfiameron	δfιαμερον
diemeron	διημερον
difiatai	διfιαται
difieus	διfιευς
difion	διfιον
difon	διfων
diosiefei	διοςιεfει
difonusoio	διfονυσοιο
difonusos	διfονυσος
dionusos	διονυσος
di*tera	διπτερα
di*teraporos	διπτεραφορος
doera	δοελα
doure	δουλη
doeros	δοελος
douros	δουλος
doeroi	δοελοι
douroi	δουλοι
donde	δονδε
do	δω
dos*ota	δοσποτα
dor*eia	δορπεια
dor*eus	δορπευς
dora	δωρα
doriefei	δωριεfει
doriefes	δωριεfες
dorieus	δωριευς
dromeus	δρομευς
didonsi	διδονσι
dido	διδω
dosei	δωσει
dosonsi	δωσονσι
dosmoi	δοσμοι
dosmos	δοσμος
dorfeios	δορfειος
dumas	δυμας
dumates	δυματες
dunioio	δυνιοιο
dunios	δυνιος
dureus	δυρευς
drutomos	δρυτομος
dutasos	δυτασος
dufou*i	δυfουπι
duo	δυο
dufoioio	δυfοιοιο
dufoios	δυfοιος
dufofeis	δυfωfεις
os	ως
kaesamenos	καεσαμενος
kaeseus	καεσευς
kaunos	χαυνος
kardamia	καρδαμια
kardamon	καρδαμον
kandaros	χανδαρος
karkeus	χαλκευς
karkeusi	χαλκευσι
karkefes	χαλκηfες
karkeus	χαλκευς
karkia	χαλκια
karkios	χαλκιος
karkeiapi	χαλκειαφι
karkon	χαλκον
karkos	χαλκος
kama	καμα
kamaeus	καμαευς
knakos	κνακος
knekos	κνηκος
kna*eus	κναπευς
kna*to	κναπτω
kar*atia	καρπαθια
kar*asia	καρπασια
ka*nia	καπνια
kar*os	καρπος
karaapi	καρααφι
kraukos	γλαυκος
karadros	χαραδρος
karadofatas	χαραδοfατας
qrekon	βληχων
krakon	γλαχων
krasma	κλασμα
krasmatos	κλασματος
kar*atos	καρπαθος
kar*asos	καρπασος
krarefeis	κλαρεfεις
krarefes	κλαρεfες
krareus	κλαρευς
kradfiporos	κλαδfιφορος
kreidoporos	κλειδοφορος
kariseus	χαρισευς
karisios	χαρισιος
karops	χαροψ
karukes	καρυκες
karuks	καρυξ
keruks	κηρυξ
karufei	καρυfει
karua	καρυα
karupi	καρυφι
karustos	καρυστος
ksantos	ξανθος
katafas	καταfας
kartis	καρτις
kastor	καστωρ
kanturefiai	κανθυληfιαι
kazoes	καζοες
kakyoes	κακyοες
kakiones	κακιονες
keiakrana	κειακρανα
keiei	κειει
keios	κειος
keus*ondas	χευσπονδας
keus*ondeia	χευσπονδεια
keousas	κεουσας
kekaumenos	κεκαυμενος
kekeimena	κεκειμενα
kekeimenos	κεκειμενος
kerkis	κελχις
kerkides	κελχιδες
kerkios	κερκιος
keraha	κεραhα
keras	κερας
keraefeis	κεραεfεις
keraeus	κεραευς
kerauios	κεραυιος
kerameus	κεραμευς
kerameus	κεραμευς
kerameia	κεραμεια
kerainos	κελαινος
keraso	κερασω
keratioioforfos	κερατιοιοfορfος
kresioferkes	κρησιοfεργης
kreteus	κρηθευς
kretifos	κρηθιfος
skerehas	σκελεhας
skeros	σκελος
keronsia	γερονσια
kerousia	γερουσια
kerofos	κεροfος
kesandros	κεσανδρος
ksenfia	ξενfια
ksenfios	ξενfιος
ksenia	ξενια
ksenios	ξενιος
kefetoio	κηfετοιο
kefetos	κηfετος
knidiai	κνιδιαι
krita	κριθα
krite	κριθη
ksifiai	ξιfιαι
kirtanos	κιρτανος
kritanos	κριτανος
ktiensi	κτιενσι
ktimena	κτιμενα
ktimenos	κτιμενος
ktitas	κτιτας
kiton	χιτων
kifon	κιfων
kodoio	κοδοιο
kodos	κοδος
kukaros	κυκαλος
kokaros	κωκαλος
korkidas	κολχιδας
korkios	κολχιος
kokkus	κογχυς
kokkuros	κογχυλος
komafeis	κομαfεις
komafentei	κομαfεντει
komafentos	κομαfεντος
komafenta	κομαfεντα
komafenteia	κομαfεντεια
skoinos	σκοινος
knosia	κνωσια
knosios	κνωσιος
knosonde	κνωσονδε
knosos	κνωσος
kopina	κοφινα
kopinos	κοφινος
koreter	κορετερ
koreteres	κορετηρες
koreterion	κορετηριον
korintia	κορινθια
korintios	κορινθιος
korinsia	κορινσια
korinsios	κορινσιος
korintos	κορινθος
koriadna	κολιαδνα
koriadnos	κολιαδνος
koriantros	κολιαντρος
kroioforfia	κροιοfορfια
kerkuraioi	κερκυραιοι
krokuraioi	κροκυλαιοι
korone	κορωνη
koronofessa	κορωνοfεσσα
koronos	κορωνος
korutpi	κορυθφι
korus	κορυς
korufeia	κορυfεια
koureia	κουρηια
ksoutos	ξουθος
ktoina	κτοινα
ktoinaon	κτοιναων
ktoinookoi	κτοινοοχοι
kotufei	κοτυfει
kotufos	κοτυfος
koturionei	κοτυριονει
koturion	κοτυριων
korfa	κορfα
kore	κορη
koure	κουρη
korfeia	κορfεια
kouria	κουρια
korfos	κορfος
kouros	κουρος
kofos	κοfος
koas	κωας
kudonia	κυδωνια
kukadaros	κυκαδαρος
kukreus	κυκλευς
kuminon	κυμινον
kunaia	γυναια
kunaiksi	γυναιξι
kunaketas	κυναγετας
ku*arisioi	κυπαρισιοι
ku*arisios	κυπαρισιος
ku*arissos	κυπαρισσος
ku*airos	κυπαιρος
ku*airofen	κυπαιροfεν
kupseros	κυψελος
ku*rios	κυπριος
kuranos	κυλανος
kourefes	κουρηfες
kouretes	κουρητες
krumenos	κλυμενος
krusos	χρυσος
krusoforkos	χρυσοfοργος
krusourkos	χρυσουργος
ksun	ξυν
sun	συν
ksum*an	ξυμπαν
sum*an	συμπαν
ksunstropa	ξυνστροφα
sustrope	συστροφη
kutaistos	κυταιστος
kutaisios	κυταισιος
kuteraios	κυθεραιος
kutereai	κυθερεαι
kutereupi	κυθερευφι
kutera	κυθηρα
kuteseiois	κυτεσειοις
kuteseios	κυτεσειος
kutisos	κυτισος
ktukianor	κτυγιανωρ
kufanos	κυfανος
kuanos	κυανος
kufanoforkos	κυfανοfοργος
mautios	μαυτιος
maka	μαγα
materkaia	ματεργαια
makafon	μαχαfων
manassa	μανασσα
mnasiferkos	μνασιfεργος
manikos	μανιχος
manouros	μανουρος
maranenioi	μαλανενιοι
marateus	μαλατευς
marteus	μαλθευς
maratefes	μαλαθηfες
martifios	μαλθιfιος
maratos	μαραθος
maratufon	μαραθυfον
mareus	μαλευς
marineus	μαρινευς
marinefeiai	μαρινεfειαι
maritas	μαλιτας
maros	μαλος
maropi	μαλοφι
mater	ματερ
materteia	ματερθεια
matro*uros	ματροπυλος
mefioha	μεfιοhα
meiona	μειονα
medeios	μεδειος
menios	μηνιος
men	μην
menas	μηνας
menos	μηνος
menoeia	μηνοεια
mareuron	μαλευρον
mereuron	μελευρον
merestriai	μελεστριαι
merin	μελιν
meriton	μελιτον
meridamates	μελιδαματες
meridumates	μελιδυματες
meritefos	μελιτεfος
meriteus	μελιτευς
meta	μετα
metakekumena	μετακεκυμενα
metaktitas	μετακτιτας
meta*a	μεταπα
meta*ande	μεταπανδε
meta*ios	μεταπιος
meto*eus	μετωπευς
mefios	μεfιος
mefion	μεfιων
meion	μειων
mefioes	μεfιοες
meiones	μειονες
mezos	μεζος
mezon	μεζων
meizon	μειζων
mezoes	μεζοες
meizones	μειζονες
mezoha	μεζοhα
meizona	μειζονα
miratiai	μιλατιαι
menta	μεντα
minta	μινθα
mirtofessa	μιλτοfεσσα
mopsos	μοψος
moreus	μολευς
moruqdos	μολυβδος
moro*ros	μοροπλος
moro*as	μοροπας
naisefios	ναισεfιος
naudomos	ναυδομος
nausikrefeis	ναυσικλεfεις
nausikres	ναυσικλης
nafios	ναfιος
nafos	ναfος
naos	ναος
nafiros	ναfιλος
nedfatas	νεδfατας
nedfa	νεδfα
nedfoten	νεδfοθεν
nedfotande	νεδfοτανδε
nedfon	νεδfων
nedefeiei	νεδεfειει
nestianor	νεστιανωρ
nefa	νεfα
nefos	νεfος
nea	νεα
neos	νεος
noperea	νωφελεα
numfaia	νυμfαια
paistia	φαιστια
paistios	φαιστιος
paistos	φαιστος
*andakeus	πανδαγευς
*andion	πανδιων
*aiafonei	παιαfονει
*aiafon	παιαfων
paskana	φασγανα
*akteres	πακτηρες
spakianai	σφαγιαναι
paskianai	φασγιαναι
spakianiai	σφαγιανιαι
spakianioi	σφαγιανιοι
paskianiai	φασγιανιαι
paskianioi	φασγιανιοι
spakosioio	σφακοσιοιο
spakosios	σφακοσιος
spakofen	σφακοfεν
*akkurion	παγχυλιων
parmakon	φαρμακον
*araios	παραιος
*araios	παλαιος
*ara	παρα
*aro	παρο
*ansa	πανσα
*ansan	πανσαν
*ansi	πανσι
pami	φαμι
pasin	φασιν
pemi	φημι
*ansiteois	πανσιθεοις
*atas	πατας
*artaia	παλταια
*arton	παλτον
*antes	παντες
*as	πας
*ater	πατερ
*antekton	παντεκτων
parfea	φαρfεα
*arforkes	παρfοργες
speis	σφεις
*eda	πεδα
*edfessa	πεδfεσσα
*edira	πεδιλα
*ekoton	πεκοτον
s*erma	σπερμα
s*ermon	σπερμον
*nefenta	πνεfεντα
*e*itmenoio	πεπιθμενοιο
*e*itmenos	πεπιθμενος
perein	φερειν
*reuron	πλευρων
*reuronande	πλευρωνανδε
*reuronios	πλευρωνιος
*erekeus	πελεκευς
*res*otas	πρεσποτας
*erimedes	περιμηδης
*eritas	πελιτας
*eriteus	περιτευς
*eritofos	περιθοfος
*erusinfa	περυσινfα
*erusina	περυσινα
*erusino	περυσινο
*erusinufo	περυσινυfο
pserros	ψελλος
*etaros	πεταλος
*terefas	πτελεfας
*terea	πτελεα
*etnios	πετνιος
*etonios	πετονιος
*etnos	πετνος
*etonos	πετονος
*ikereus	πικερευς
*i*es	πιπης
priai	φλιαι
priaion	φλιαιων
*rieter	πριετερ
*rieteres	πριετερες
*rietesi	πριετεσι
piroferkos	φιλοfεργος
*isfatas	πισfατας
*itakeus	πιτακευς
*tiriofessa	πτιλιοfεσσα
*tiron	πτιλον
piharai	φιhαλαι
piare	φιαλη
pieraiai	φιελαιαι
*odarkos	ποδαργος
*odei	ποδει
*ous	πους
*opi	ποφι
*oikironuka	ποικιλωνυχα
*oimenei	ποιμενει
*oimenos	ποιμενος
*oimen	ποιμην
poinikei	φοινικει
poinikia	φοινικια
poinikios	φοινικιος
*orpureia	πορφυρεια
*orpurion	πορφυριων
porqeiai	φορβειαι
porefiai	φορεfιαι
peromai	φερομαι
porenai	φορηναι
*orifos	πολιfος
*oros	πωλος
*oros	πωρος
*roekes	προεχης
*routeus	πλουτευς
*rodumates	προδυματες
*rokoreteres	προκορετερες
*roteus	πρωτευς
*rofistoio	πλωfιστοιο
*rofistos	πλωfιστος
*orukastos	πολυκαστος
*oru*odei	πολυποδει
*oru*ous	πολυπους
*oruqotas	πολυβοτας
*oseidaonei	ποσειδαονει
*oseidaon	ποσειδαων
*osi	ποσι
*osidaeia	ποσιδαεια
*osidaefes	ποσιδαεfες
*osidaikeus	ποσιδαιγευς
*osidaion	ποσιδαιον
oiketes	οικετης
*osiketeres	ποσικετερες
psoprei	ψωφρει
psopres	ψωφρης
psorakos	ψωρακος
psoreia	ψωρεια
psoros	ψωρος
*otnia	ποτνια
*otneiai**eia	ποτνειαιππεια
*otniafeia	ποτνιαfεια
*otniafeios	ποτνιαfειος
*ortis	πορτις
*ortipi	πορτιφι
*ontiroi	ποντιλοι
*ukeseros	πυγεσερος
*ukseros	πυξελος
*uksos	πυξος
*urautron	πυραυθρον
*urasos	πυρασος
*uratas	πυρατας
*uros	πυλος
kadasos	καδασος
karnufasos	καρνυfασος
kfara	κfαρα
kfaraisos	κfαραισος
kfaratron	κfαλαθρον
s*aratron	σπαλαθρον
qasireus	βασιλευς
kfasireus	κfασιλευς
kfasirefia	κfασιλεfια
kekinomena	γεγινωμενα
kekinomenos	γεγινωμενος
kekinotos	γεγινωτος
dinotos	δινωτος
kerana	κερανα
kerna	κερνα
terasia	θηρασια
kerasia	κερασια
qretrio	βλητριω
qretron	βλητρον
ketrakeus	κετραγευς
ketafos	κεταfος
tertos	τελθος
*itos	πιθος
*etro*opi	πετροποφι
tetro*opi	τετροποφι
*etrofeis	πετρωfεις
tetrofeis	τετρωfεις
ksipee	ξιφεε
ksipe	ξιφη
qous	βους
kfoos	κfοος
qoukara	βουκαρα
qoukrania	βουκρανια
qoukoros	βουκολος
qouqotas	βουβοτας
qromuros	βρωμυλος
korfia	κορfια
koureia	κουρηια
raas	λαας
raeia	λαεια
raia	ραια
rakeus	λαχευς
rakedaimonios	λακεδαιμονιος
rakedamnios	λακεδαμνιος
rakuros	λαχυρος
ramniai	λαμνιαι
remniai	λημνιαι
rampsakos	λαμψακος
ra*andos	λαπανδος
ra*atos	λαπατος
ra*triai	ραπτριαι
rasuntios	λασυνθιος
rasuntos	λασυνθος
ratios	λατιος
rato	λατω
rafakeia	λαfαγεια
rafakesia	λαfαγεσια
rafakesios	λαfαγεσιος
rafakesiaion	λαfαγεσιαιον
rafaketas	λαfαγετας
rafrantai	λαfρανθαι
rafos	λαfος
raos	λαος
rafodokos	λαfοδοκος
rafo*onos	λαfοπονος
ra*ter	ραπτερ
reukasos	λευκασος
reukos	λευκος
reukorooprus	λευκοροοφρυς
reukonuka	λευκονυχα
reuktroi	λευκτροι
reuktron	λευκτρον
rekestroterion	λεχεστρωτηριον
re*eurios	λεπευριος
re*ton	λεπτον
refontiois	λεfοντιοις
refontpi	λεfοντφι
refon	λεfων
refos	λεfος
refotereion	λεfοτερειον
reqes	λεβης
reqetarion	λεβηταριον
refotrokorfoi	λεfοτροκορfοι
rion	ριον
rionde	ριονδε
rimenei	λιμενει
rimen	λιμην
rinakros	λιναγρος
rineiai	λινειαι
rinon	λινον
roikos	ροικος
roofa	ροοfα
rousiefeiai	λουσιεfειαι
rousios	λουσιος
rousos	λουσος
rokos	λωχος
rukintios	λυκινθιος
rukintos	λυκινθος
rukouros	λυκουρος
rukoforos	λυκοfορος
runasos	ρυνασος
ruratas	λυρατας
sakereus	σαγηλευς
sakreus	σαγρευς
samara	σαμαρα
samarifa	σαμαριfα
spakteriai	σφακτηριαι
spaktria	σφακτρια
sar*ides	σαρπιδες
sra*edas	σραπεδας
sarinoufontei	σαλινουfοντει
serinous	σελινους
serinopontei	σελινοφοντει
sasama	σασαμα
sesame	σησαμη
serinon	σελινον
setoiai	σητοιαι
sikadufeis	σιγαδυfεις
sima	σιμα
simakos	σιμακος
sminteus	σμινθευς
sinouros	σινουρος
sirioio	σιριοιο
sirios	σιριος
siton	σιτον
sitokorfoi	σιτοκορfοι
sito*otnia	σιτοποτνια
siharos	σιhαλος
souros	σουρος
sofenoi	σοfενοι
sofenos	σοfενος
sudnikos	συδνικος
sukrita	συγριτα
suqotas	συβοτας
surimos	συριμος
suros	συρος
suferofios	συfεροfιος
suza	συζα
sukya	συκyα
suka	συκα
tamieus	ταμιευς
tanikos	τανιχος
tarpa	ταρφα
taramatas	θαλαματας
taramika	θαλαμικα
taramiska	θαλαμισκα
tranufes	θρανυfες
tranus	θρανυς
taransia	ταλανσια
tarsus	θαρσυς
startakeus	σταρταγευς
stratekos	στρατηγος
tantaros	τανταλος
stateres	στατηρες
stati*ofeus	στατιποfευς
statmos	σταθμος
teoio	θεοιο
teois	θεοις
teon	θεον
teos	θεος
teodora	θεοδωρα
teoporia	θεοφορια
teukea	τευχεα
teukespi	τευχεσφι
teukos	τευχος
teto	θετω
teke	θηκε
tektones	τεκτονες
temenos	τεμενος
temistia	θεμιστια
termintia	τερμινθια
teqai	θηβαι
teqande	θηβανδε
tekqaia	θηκβαια
terestai	τελεσται
terestas	τελεστας
terestaon	τελεσταων
terouros	τελουρος
teseus	θησευς
tetukufoa	τετυχυfοα
tetrufes	τεθρυfες
termintos	τερμινθος
tirmintos	τιρμινθος
temistonakos	θεμιστωναγος
temitosakos	θεμιτοςαγος
termintonakkos	τερμινθωναγκος
tridaros	τριδαρος
tria	τρια
trisi	τρισι
triofeis	τριωfεις
tri*ous	τριπους
tri*os	τριπως
tri*odiskoi	τριποδισκοι
triserois	τρισηρωις
trisiroei	τρισιρωει
tinfasia	τινfασια
auton	αυτον
toe	τοε
autou	αυτου
toio	τοιο
tou	του
tokeus	τοκευς
toikodomoi	τοιχοδομοι
toksotas	τοξοτας
toksforkos	τοξfοργος
toksoforkos	τοξοfοργος
stomarkos	στομαργος
tome	τομε
tone	τονε
tornos	θορνος
tronos	θρονος
tornoerketerion	θορνοελκητηριον
tor*eza	τορπεζα
tra*eza	τραπεζα
tor*idfessa	τορπιδfεσσα
tor*idei	τορπιδει
tor*ideia	τορπιδεια
tor*ideios	τορπιδειος
tor*is	τορπις
tro*is	τροπις
torakes	θωρακες
toraks	θωραξ
torios	θωριος
tornoforkos	θορνοfοργος
tosa	τοσα
tosai	τοσαι
tosade	τοσαδε
tosoio	τοσοιο
tosone	τοσονε
tososde	τοσοσδε
tosos*as	τοσοσπας
tosoi	τοσοι
toson	τοσον
toton	τοτον
tukater	θυγατερ
tukateres	θυγατερες
tukeneus	τυχενευς
terateus	θηρατευς
turisia	τυλισια
turisios	τυλισιος
turisos	τυλισος
turitas	τυλιτας
stru*teria	στρυπτερια
tufea	θυfεα
tufos	θυfος
tufestas	θυfεστας
turion	τυριον
fanaktei	fανακτει
fanaktos	fανακτος
fanaks	fαναξ
fanaktera	fανακτερα
fanakteron	fανακτερων
anaktora	ανακτορα
fanassa	fανασσα
fanasefia	fανασεfια
fanasefios	fανασεfιος
fanasos	fανασος
fanataios	fαναταιος
fanikos	fανιχος
fanoioforfos	fανοιοfορfος
fa*paroio	fαπφαλοιο
fa*paros	fαπφαλος
fatos	fατος
fastu	fαστυ
fastuokos	fαστυοχος
feareia	fεαλεια
feareios	fεαλειος
uareia	υαλεια
uareios	υαλειος
fendaneus	fενδανευς
fek*eza	fεκπεζα
fetos	fετος
fefesioio	fεfεσιοιο
fefesios	fεfεσιος
fehanos	fεhανος
fidofoios	fιδοfοιος
fiduros	fιδυλος
fidoufakos	fιδουfακος
fipinoos	fιφινοος
frineios	fρινειος
frinos	fρινος
fiseios	fισειος
fisuros	fισυλος
fitimios	fιτιμιος
fiturios	fιτυλιος
foikonde	fοικονδε
foikos	fοικος
oikos	οικος
fordofen	fορδοfεν
rodoen	ροδοεν
foka	fοχα
fonefei	fονεfει
foneus	fονευς
foinos	fοινος
fonokefan	fονοκεfαν
fonokefei	fονοκεfει
fonokeus	fονοκευς
foinops	fοινωψ
fokefei	fοκεfει
fokeus	fοκευς
forafessa	fοραfεσσα
forkioneios	fοργιονειος
forkiones	fοργιονες
orkeones	οργεωνες
froneia	fρονεια
arneia	αρνεια
forfos	fορfος
orion	οριον
oros	ορος
forzontes	fορζοντες
forzon	fορζων
forzomena	fορζομενα
forzomenos	fορζομενος
zaetroi	ζαεθροι
zakuntios	ζακυνθιος
zakunsios	ζακυνσιος
zamaefiai	ζαμαεfιαι
zafetes	ζαfετες
zeiakrana	ζειακρανα
zeukesi	ζευγεσι
zeukos	ζευγος
zesomenos	ζεσομενος
zepurai	ζεφυραι
zepuros	ζεφυρος
zepureai	ζεφυρεαι
zofios	ζωfιος
harosudorpi	hαλοσυδωρφι
harufoten	hαρυfοθεν
karuqdos	χαρυβδος
hateros	hατερος
eteros	ετερος
aiksma	αιξμα
aiksmans	αιξμανς
aikme	αιχμη
aikeus	αιγευς
aikinoos	αιγινοος
aiki*atas	αιγιπατας
aiki*os	αιγιπως
aikiharios	αιγιhαλιος
aikontas	αικοντας
aiku*tios	αιγυπτιος
aitareus	αιθαλευς
aitareusi	αιθαλευσι
aitarofeis	αιθαλοfεις
aitio*es	αιθιοπες
aitiops	αιθιοψ
aiton	αιθων
aifaia	αιfαια
aia	αια
aifatas	αιfατας
aiforos	αιfολος
aika	αιγα
aiza	αιζα
aikai	αιγαι
aizai	αιζαι
aukefan	αυγεfαν
aukeus	αυγευς
auroi	αυλοι
auros	αυλος
autias	αυτιας
dfo	δfο
dufo	δυfο
duo	δυο
pukes	φυγης
pukekres	φυγεκλης
pusiarkos	φυσιαρχος
puter	φυτερ
puteria	φυτερια
puriasakreus	φυλιαςαγρευς
ptenoi	φτενοι
